%%%%%%%%%%%%%%%%%%%%
%....%........%....%
%.%%.%.%%%%%%.%.%%.%
%.%..............%.%
%.%.%%.%%..%%.%%.%.%
%......%....%......%
%.%.%%.%%%%%%.%%.%.%
%.%..............%.%
%.%%.%.%%%%%%.%.%%.%
%....%...P....%....%
%%%%%%%%%%%%%%%%%%%%
