%%%%%%%%%
%.P.....%
%.%.%.%%%
%.....%%%
%%%%%%%%%
