%%%%%%%%%%%%%%%%%%%%%%
% %%    .   % % ..   %
% .  %%%%%% % %%%%%% %
%%%%%%  .   P  % ..  %
%    % %%%%%% %% %%%%%
% %%%% %   .  .  %   %
%   .  . %%% %%%   % %
%%%%%%%%%% .  %%%%%% %
%.  .  .   %% . . .  %
%%%%%%%%%%%%%%%%%%%%%%